11111
1E0C1
11101
1C0C1
10111
1C1C1
10101
100P1
11111