111111111
1000C0001
1C1010101
1110000C1
1C001C101
11PE100C1
111111111