111111111111111111
10P01K100011K100K1
10000000001101C001
1000111C000C000001
11011E1000110100K1
100010101011011001
1000K0K01011C110E1
101111111K11111111
10100000000001CCC1
101C10000000010001
1C11111000000100K1
101E00000000000001
101100110000010001
100100K10111110111
100000K10001E00001
110000K10001000001
111C1111C0K10C0011
111111111111111111