R 850 550
NO ./textures/xpm/colorstone.xpm
SO ./textures/xpm/colorstone.xpm
WE ./textures/xpm/greystone.xpm
EA ./textures/xpm/mossy.xpm

S ./textures/xpm/monster.xpm
C 40,40,40
F 10,10,10

111111111111111
100000000000001
100200000000001
100200000000001
100200000000001
1000000N0000001
111111111111111