1111111111111
1000C010C0001
10K0000000K01
1000K101K0001
10C011P110C01
1000K1C1K0001
10K0000000K01
1000C010C0001
1111111111111