1111111111111
1000K010K0001
10K0000000K01
1000E101E0001
10K011P110K01
1000E1K1E0001
10K0000000K01
1000K010K0001
1111111111111