1111111111111
1000C010C0001
10K0000000K01
1000E101E0001
10C011K110C01
1000E1C1E0001
10K0000000K01
1000C010C0001
1111111111111