1111111111111111111111111111111111111111111111111
1000000000000000P00000000000000000000000000000001
1000000000000000000000000000000C00000000000000001
1000000000000000000000000000000000000000000000001
1000000000000000000000000000000000C00000000000001
1000000C00000000000000000000000000000000000000001
10000C000000000000000C000000000C00000000000000001
10000000000000000000000000000000000000C0000000001
100000000000000000000000000000C000000000000000001
1000000000C00000000000000000000000000000000000001
1000000000000000000000000000000000000000000000001
1000000000000000000000C000000000000C0000000000001
100000000000C000000000000000000000000000000000001
100000000000000000000000000C000000000000000000001
100000000000000011000000000000000000000000C000001
100000C000000000100000000000000000000000000000001
1000000000000000100000000000000000000C00000000001
100000000000000010000000C000C00000000000000000001
1000000000000000100000000000000000000000000000001
10000000000000001000000000000000000000C0000000001
1000C00000000000000000000000000000000000000000001
100000000000E000000000000C00000000000000000000001
10000000000C00000000000000000C0000000000000000001
100000C00000000000000000000000000000000000C000001
1000000000000000000000000000000000000000000000001
100000000000000000000E000000000C0000000C000000001
1000000C00000000000000000000000000000000000000001
10000000000000C0000000000000000000000000000000001
1000000000000000000000000000000000000000000000001
10000000000000000000000C000000000C000000000000001
1000000C0000000000000000000000000000000000C000001
1000000000000000000000000000000000000000000000001
1000000000000000000000000000000000000000000000001
1000000000000000C000000000000000C0000000000000001
100000000000000000000000000000000000000C000000001
10000C000000000000000C000000000000000000000000001
1000000000000000000000000000000000000000000000001
1111111111111111111111111111111111111111111111111